REB = "countries/Rebels.txt"
SYN = "countries/Synthetics.txt"
PIR = "countries/Pirates.txt"
NAT = "countries/Natives.txt"
EHR = "countries/Ehrenia.txt"
TML = "countries/Tummland.txt"
NAR = "countries/New Argenia.txt"
DR1 = "countries/Drachenburg.txt"
NID = "countries/Nidervlania.txt"
ADR = "countries/Adria.txt"
FLT = "countries/Faltinland.txt"
VRT = "countries/Veritia.txt"
ADL = "countries/Adlerland.txt"
VLD = "countries/Volodia.txt"
BOH = "countries/Bohemia.txt"
VTR = "countries/Voltirenmark.txt"
ORD = "countries/Ordirria.txt"
FAR = "countries/Farmirria.txt"
MNB = "countries/Mannerburg.txt"
OKR = "countries/Ostkardia.txt"
WKR = "countries/Westkardia.txt"
MKR = "countries/Mittelkardia.txt"
KAR = "countries/Kardia.txt"
BRN = "countries/Brensigland.txt"
MEU = "countries/Meusserland.txt"
KRB = "countries/Kredberg.txt"
IC1 = "countries/Svorburg.txt"
IC2 = "countries/Meusserstadt.txt"
IC3 = "countries/Imperstadt.txt"
IC4 = "countries/Freiburg.txt"
IC5 = "countries/Merstadt.txt"
IC6 = "countries/Altendrachenburg.txt"
IC7 = "countries/Stipule.txt"
IC8 = "countries/Altstadt.txt"
IC9 = "countries/Nurrstadt.txt"
IC0 = "countries/Adlerstadt.txt"
FC0 = "countries/Hatrienstadt.txt"
FC1 = "countries/Grauenburg.txt"
RHM = "countries/Ruhmenttins.txt"
NVL = "countries/Nordvoltria.txt"
SVL = "countries/Sudvoltria.txt"
VLT = "countries/Voltria.txt"
ABN = "countries/Adlerboden.txt"
NRR = "countries/Nurrland.txt"
HRT = "countries/Horthria.txt"
VAU = "countries/Vauenberg.txt"
KDM = "countries/Keredenmarches.txt"
NRM = "countries/Nordmark.txt"
LNF = "countries/LesserNifthem.txt"
KND = "countries/Karriend.txt"
BLU = "countries/Blauwald.txt"
FLA = "countries/FolindanLatiringen.txt"
INH = "countries/Infhem.txt"
ALR = "countries/Altrenland.txt"
FEU = "countries/Feurirland.txt"
ELT = "countries/Eltyren.txt"
PLD = "countries/Polderland.txt"
KUN = "countries/Kunsdag.txt"
PAP = "countries/Papal.txt"
KAT = "countries/Kaitatie.txt"
NAI = "countries/Naisenala.txt"
RAU = "countries/Rautakaihas.txt"
TUL = "countries/Tulvayleinen.txt"
AAP = "countries/Aapotorni.txt"
SKA = "countries/Skaarrannik.txt"
PYH = "countries/Pyhakkonsa.txt"
MIE = "countries/Miekkatihmiset.txt"
CIE = "countries/Ciehralagan.txt"
BIE = "countries/Bieggolmaimannat.txt"
BAL = "countries/Balwalasgiergge.txt"
VEN = "countries/Venaklulle.txt"
IGN = "countries/Ignidunta.txt"
NRB = "countries/Narbonia.txt"
OLG = "countries/Olegaria.txt"
BRA = "countries/Bratetia.txt"
PAD = "countries/Pados.txt"
NAH = "countries/Al-Nahralnoriya.txt"
RIY = "countries/Riyaduna.txt"
ANT = "countries/Antawil.txt"
ALG = "countries/Algharbiya.txt"
ALT = "countries/Altaliqadim.txt"
HAR = "countries/Harba.txt"
HAM = "countries/Hamadani.txt"
IFR = "countries/Al-ifrita.txt"
PUI = "countries/Puiduhakkurmaa.txt"
POH = "countries/Pohjavalvur.txt"
VAN = "countries/Vanavalvur.txt"
MLP = "countries/Maalopp.txt"
LOU = "countries/Lounavalvur.txt"
UZK = "countries/Uzkolia.txt"
CHE = "countries/Chelufia.txt"
CHA = "countries/Chalia.txt"
TER = "countries/Terolia.txt"
CHO = "countries/Chofeudia.txt"
VET = "countries/Vetica.txt"
CRS = "countries/Crossed Spears.txt"
ANA = "countries/Antauria.txt"
HER = "countries/Hermatia.txt"
DAG = "countries/Dagica.txt"
ABO = "countries/Abochia.txt"
PEL = "countries/Pelian.txt"
CAP = "countries/Capiranela.txt"
SER = "countries/Serenima.txt"
SAG = "countries/Saganaria.txt"
DGL = "countries/Dagillo.txt"
GRA = "countries/Grafouli.txt"
SAR = "countries/Sarneo.txt"
EST = "countries/Estne.txt"
CHL = "countries/Cholia.txt"
MAC = "countries/Macono.txt"
CON = "countries/Conferma.txt"
SCU = "countries/Scuneo.txt"
ORA = "countries/Orasolo.txt"
PIE = "countries/Pietrania.txt"
RUB = "countries/Rubmeo.txt"
VIA = "countries/Viacheil.txt"
TIE = "countries/Tiepol.txt"
PDN = "countries/Paduaono.txt"
ALB = "countries/Alabergia.txt"
BRI = "countries/Brianola.txt"
VEC = "countries/Veceingo.txt"
ZON = "countries/Zonachia.txt"
COR = "countries/Coraniro.txt"
HRC = "countries/Hercogaosta.txt"
ZIE = "countries/Ziemelia.txt"
EGL = "countries/Eglekus.txt"
MEZ = "countries/Mezonia.txt"
ALI = "countries/Aligeland.txt"
MUT = "countries/Mutova.txt"
BIR = "countries/birzas.txt"